1 1 1 1 1 1 1
1 0 0 0 0 0 1 
1 0 g 0 0 0 1 
1 x 0 x 0 0 1 
1 x 0 x 0 0 1 
1 0 ^ 0 0 0 1
1 0 0 0 0 0 1
1 1 1 1 1 1 1

0.16 0.32 0.45
0.16 0.32 0.45
0.16 0.32 0.45
