1 1 1 1 1 1 1
1 0 0 0 0 0 1 
1 0 g 0 0 0 1 
1 x 0 x 0 0 1 
1 x 0 x 0 0 1 
1 0 0 0 0 0 1 
1 0 0 0 0 0 1
1 0 0 0 1 1 1
1 0 0 0 1 1 1
1 0 0 0 1 1 1
1 0 0 0 1 1 1
1 0 ^ 0 1 1 1
1 1 1 1 1 1 1

0.010 0.015 0.020 0.025 0.030 0.035 0.040 0.045 0.050
0.010 0.015 0.020 0.025 0.030 0.035 0.040 0.045 0.050
0.010 0.015 0.020 0.025 0.030 0.035 0.040 0.045 0.050
